FE8 - Village - 0e000f10
20 20
478 507 474 507 474 474 474 474 538 475 475 507 539 437 437 437 876 422 870 929
478 475 475 539 474 474 474 538 538 539 474 475 475 812 911 878 912 486 840 961
478 475 475 474 474 538 538 538 538 506 475 475 475 876 555 549 549 516 548 516
478 475 475 475 539 507 403 410 474 475 475 475 475 876 800 801 742 516 516 516
478 475 475 475 475 506 222 441 475 475 475 538 475 876 772 773 774 987 516 516
656 719 475 475 539 251 252 253 254 475 538 538 475 624 877 580 516 516 516 516
317 751 475 475 282 283 284 285 286 287 539 474 539 474 844 877 877 846 516 516
317 390 359 359 391 315 525 525 318 319 538 474 844 877 317 386 352 908 454 516
317 751 475 474 346 525 525 525 525 390 359 359 391 445 525 525 525 555 516 516
317 751 474 474 378 445 386 525 525 280 474 475 281 445 317 317 812 650 713 454
317 751 474 507 281 445 525 525 525 280 538 475 624 623 525 525 908 548 651 389
656 722 474 507 249 445 525 525 525 280 507 475 475 475 794 302 484 484 549 580
474 474 474 507 281 445 525 525 525 280 506 539 474 572 508 302 484 484 589 877
474 474 474 539 249 445 525 317 525 280 507 474 474 475 475 794 589 589 589 365
474 474 474 507 307 244 344 343 277 339 506 474 475 475 589 589 317 589 475 538
602 538 475 539 372 373 374 375 376 377 507 538 475 507 219 557 352 908 403 410
763 474 474 474 404 405 406 407 408 409 507 538 474 474 219 526 384 983 222 441
461 763 474 475 507 437 438 439 440 506 475 538 539 507 219 589 317 282 252 253
516 795 474 474 475 507 602 602 506 538 539 538 506 475 219 557 954 314 284 285
795 511 511 511 479 511 403 410 506 507 403 410 538 475 219 557 390 391 525 525
